{
    "layout": [
        "#########",
        "#   #   #",
        "#       #",
        "## ## ###",
        "##      #",
        "##      #",
        "#########"
    ],
    "box_target": {
        "4,4": "2,3",
        "4,5": "2,4",
        "4,6": "2,5"
    },
    "player": "5,3"
}