{
    "layout": [
        "######",
        "#    #",
        "#    #",
        "# # ##",
        "#    #",
        "#    #",
        "######"
    ],
    "box_target": {
        "2,3": "2,1",
        "3,3": "3,1"
    },
    "player": "5,3"
}